xp 1: 
Ãğóïïû: 1,4,20,22,23,29,30,32,34,35,42,44,45,46,49,50,51,52,53,54,55,56,57,58,59,60
stage 1:
1,20,29,30,34,35,46,49
3,0,0,1,0,0,0,0,0,0,0,0,0,0,0,0,0,0,0,3,0,1,1,0,0,0,0,0,3,3,0,1,0,3,3,0,0,0,0,0,0,1,0,1,1,3,0,0,3,1,1,1,1,1,1,1,1,1,1,1
----------------------------------------
stage 2:
1,4,29,34,35,45,50
3,0,0,3,0,0,0,0,0,0,0,0,0,0,0,0,0,0,0,1,0,1,1,0,0,0,0,0,3,1,0,1,0,3,3,0,0,0,0,0,0,1,0,1,3,1,0,0,1,3,1,1,1,1,1,1,1,1,1,1
----------------------------------------
stage 3:
1,20,29,30,34,35,46,51
3,0,0,1,0,0,0,0,0,0,0,0,0,0,0,0,0,0,0,3,0,1,1,0,0,0,0,0,3,3,0,1,0,3,3,0,0,0,0,0,0,1,0,1,1,3,0,0,1,1,3,1,1,1,1,1,1,1,1,1
----------------------------------------
stage 4:
1,4,29,34,35,45,52
3,0,0,3,0,0,0,0,0,0,0,0,0,0,0,0,0,0,0,1,0,1,1,0,0,0,0,0,3,1,0,1,0,3,3,0,0,0,0,0,0,1,0,1,3,1,0,0,1,1,1,3,1,1,1,1,1,1,1,1
----------------------------------------
stage 5:
1,20,29,30,34,35,46,53
3,0,0,1,0,0,0,0,0,0,0,0,0,0,0,0,0,0,0,3,0,1,1,0,0,0,0,0,3,3,0,1,0,3,3,0,0,0,0,0,0,1,0,1,1,3,0,0,1,1,1,1,3,1,1,1,1,1,1,1
----------------------------------------
stage 6:
4,22,32,42,44,45,54
1,0,0,3,0,0,0,0,0,0,0,0,0,0,0,0,0,0,0,1,0,3,1,0,0,0,0,0,1,1,0,3,0,1,1,0,0,0,0,0,0,3,0,3,3,1,0,0,1,1,1,1,1,3,1,1,1,1,1,1
----------------------------------------
stage 7:
4,22,23,32,42,45,55
1,0,0,3,0,0,0,0,0,0,0,0,0,0,0,0,0,0,0,1,0,3,3,0,0,0,0,0,1,1,0,3,0,1,1,0,0,0,0,0,0,3,0,1,3,1,0,0,1,1,1,1,1,1,3,1,1,1,1,1
----------------------------------------
stage 8:
1,20,29,30,34,35,46,56
3,0,0,1,0,0,0,0,0,0,0,0,0,0,0,0,0,0,0,3,0,1,1,0,0,0,0,0,3,3,0,1,0,3,3,0,0,0,0,0,0,1,0,1,1,3,0,0,1,1,1,1,1,1,1,3,1,1,1,1
----------------------------------------
stage 9:
20,29,34,46,57
1,0,0,1,0,0,0,0,0,0,0,0,0,0,0,0,0,0,0,3,0,1,1,0,0,0,0,0,3,1,0,1,0,3,1,0,0,0,0,0,0,1,0,1,1,3,0,0,1,1,1,1,1,1,1,1,3,1,1,1
----------------------------------------
stage 10:
1,4,29,34,35,45,58
3,0,0,3,0,0,0,0,0,0,0,0,0,0,0,0,0,0,0,1,0,1,1,0,0,0,0,0,3,1,0,1,0,3,3,0,0,0,0,0,0,1,0,1,3,1,0,0,1,1,1,1,1,1,1,1,1,3,1,1
----------------------------------------
stage 11:
1,4,23,34,42,45,59
3,0,0,3,0,0,0,0,0,0,0,0,0,0,0,0,0,0,0,1,0,1,3,0,0,0,0,0,1,1,0,1,0,3,1,0,0,0,0,0,0,3,0,1,3,1,0,0,1,1,1,1,1,1,1,1,1,1,3,1
----------------------------------------
stage 12:
4,22,23,32,42,45,60
1,0,0,3,0,0,0,0,0,0,0,0,0,0,0,0,0,0,0,1,0,3,3,0,0,0,0,0,1,1,0,3,0,1,1,0,0,0,0,0,0,3,0,1,3,1,0,0,1,1,1,1,1,1,1,1,1,1,1,3
----------------------------------------

